F 76,76,76


NO   		./textures/text.xpm
SO     ./textures/text_2.xpm
WE ./textures/text.xpm
EA ./textures/text_2.xpm


C99						    ,99,1
	1111111111111111111
	10S1001001001000001
	1011000001000001001
	1001001001111101111
	1111111111111111111
	1111111111111111111
	1001111000001001001
	1111000           1000000001001
		1001111111111001001
	111100001 100001011
	100000001 100000001
	111111111 111111111
