NO ./test_files/textures/fn.xpm
SO ./test_files/textures/fs.xpm
WE ./test_files/textures/fw.xpm
EA ./test_files/textures/fe.xpm

C 0,150,200
F 141,242,158

     1
11111 111111111111111111111111
1E                            1
11111 111111111111111111111111
     1