WE ./textures/text.xpm

F        251		,  100, 4
SO ./textures/text_2.xpm

NO ./textures/text.xpm

   C 25 ,0 ,1
EA ./textures/text_2.xpm

 1
111111111111111111111
1010000010000001
10101010101111111
100010100010000010001
111110101111101011101
100000101000101000001
101111101011101111111
101000001010100000101
101011111010111110101
101010001010100010101
101110101010101010101
100000101010001010001
111111101011111011101
100000101000100010001
101110101110101110111
101000100000100010101
101011111111111010101
100010000000000010001
101010111011111111101
1N1000001000000000001
111111111111111111111


